1111111111
1        1
1 2   2  1
1        1
1   11   3
1        1
1        1
1        1
1        1
1 991999 1
1 1 1    1
1   1 11 1
11  1    1
1   1    1
1   1 22 1
1   1    1
1 3      1
1   1    1
1   1    1
1111111111
