##########
#        #
# #   #  #
#        #
#   ##   #
#        #
#        #
#        #
#        #
#   #    #
##########
