########################################
#                                      #
#                                      #
#     ####                ###          #
#                                      #
#                                      #
#                                      #
#              #######                 #
#              #     #                 #
#              #                       #
#              #     #                 #
#              #######                 #
#                                      #
#                                      #
#              ####                    #
#                #                     #
#               #                      #
#                                      #
#  ####       ##########       #####   #
#                                      #
#                                      #
#                                      #
#                                      #
#                                      #
#                                      #
#                                      #
#                                      #
#                                      #
#                                      #
#                                      #
#                                      #
#                                      #
#                                      #
#                                      #
#                                      #
#                                      #
#                                      #
#                                      #
#                                      #
########################################